#############################
#...........................y
#.###########################
##..........................#
###########################.#
###..#.#....................#
##..#.#.#####################
#..###.######################
#..#.########################
##.#........#################
#..#.######.#################
#..#.######.#################
#..#.######....##############
#..#.##########.#############
#..#.##########.#############
#..#.##########....##########
#..#.##.......####.##########
##.#.##.#####.####.##########
##.#.##.#.###.####...########
##.#.##.##..#.######.########
##.##...##..#.######...######
##.#.##.....#.#....####.#####
#..#.##.##.##.#.##....#.#####
#..#.##.##.##.#.##..#.#.#####
#..#.##.......#.##..###...###
#..#.#####.####.##...####.###
#..#.#####.#..#.....#####.###
#..#.##....#..####.######.###
#..#.##.####..####.######..##
##.#.##............#######.##
##.#.#####################..#
##.#.#######################x
##.#.########################
##...########################
#############################