########################
#.......#..............#
#.#.###................#
#...#...##.###########.#
#.#...##....#...#..#...#
#...#.#..#..#.....#..###
x.#.#.#.##.#.#...#..#..y
#.....#......#......#.##
###...#.#####..........#
#.....#......#.....#...#
#.....#......#.....#..##
#.......#....#....#...##
#.....#......#....#...##
#.....#......#....#...##
########################