####y###############################################
#..#...............................................#
##.#...............................................#
#...#..............................................#
#..................................................#
#..................................................#
#..................................................#
x..................................................#
#..................................................#
#..................................................#
#..................................................#
#..................................................#
#..................................................#
#..................................................#
#..................................................#
#..................................................#
#..................................................#
#..................................................#
#..................................................#
#..................................................#
#..................................................#
#..................................................#
#..................................................#
#..................................................#
#..................................................#
#..................................................#
#..................................................#
#..................................................#
#..................................................#
#..................................................#
#..................................................#
#..................................................#
#..................................................#
#..................................................#
#..................................................#
#..................................................#
#..................................................#
#..................................................#
#..................................................#
#..................................................#
#..................................................#
#..................................................#
#..................................................#
#..................................................#
#..................................................#
#..................................................#
#..................................................#
#..................................................#
#..................................................#
#..................................................#
#..................................................#
#..................................................#
#..................................................#
#..................................................#
#..................................................#
#..................................................#
#..................................................#
#..................................................#
#..................................................#
#..................................................#
#..................................................#
#..................................................#
#..................................................#
####################################################
