###################################################y############x###############
#........................................................##..#.....#.#.#.#.#.#.#
#..########..##########################################..##....................#
#............##........##........##..........##......##..####################..#
#..##..########..####..####..##..##..##..##..##..##..##..##....................#
#..##........##..............##......##..##..##..##..##..##..################..#
#..##......######..####..##..##########..##..##..##......##................##..#
#..##............##........##............##..##....######################..##..#
#..##......####..##..##..######..######..................##................##..#
#..##......####........####......##..............##..##..##..################..#
#..##........##..##..##..........##..........######..##..##..##............##..#
#..########........##..########################..........##..##..########..##..#
#..##..........................................############..##..##........##..#
#..##..####..################################..####......##..##..##...##...##..#
#..##..........................................##....##..##..##..##........##..#
#..########################..##..################..##....##......##........##..#
#..##........##......##......##................##..##..############...#######..#
#..##..##....##..##..##..##..####......##..##..##..##......................##..#
#..##..##....##..##..##..##..####..##..######..##..##..##..##..##..##..##..##..#
#......##........##......##........##..........##......##......................#
#..######################################################..##..##..##..##..##..#
#..##............##..............##......##................................##..#
#..############..##..##########..##..##..##..############..##..##..##..##..##..#
#..##............##..........##..##..##......##........##......................#
#..##..####################..##..##..##########..####..##..##..##..##..##..##..#
#..##............##..........##..##...............#........................##..#
#..############..##..##########..##############.....#...##..##..#########..##..#
#..##............##...........................##..########..##..##..##..#..##..#
#..##..#############################################...........................#
#.##########...............######################.....###################.######
#.##########.#############....###################.#######################.######
#.#########...############..##...###############...#############...#####...#####
#.########..#..###########..#####...###########..#..##########..###..#..###..###
#.#######..###..##########..#######..#########..###..########..######.######..##
#.######..#####..#########..########..#######..#####..#######..#############..##
#.#####..#######..########..########..######..#######..######..############..###
#.####.............#######..#######..######.............#######..########..#####
#.###..###########..######..#####...######..###########..########..####..#######
#.##..#############..#####..##...########..#############..########..##..########
#.#...#############...####....##########...#############...#########..##########
#.###########################............#######################################
#.########........#########.........#########.........#########.........########
#.########........#########.........#########.........#########.........########
#.###..................####..............####..............####.............####
#.###.####........####.####.........####.####.........####.####.........###.####
#.###.####........####.####.........####.####.........####.####.........###.####
#.........####.####........####.####.........####.####.........####.####.......#
#.........####.####........####.####.........####.####.........####.####.......#
#..............####.............####..............####..............####.......#
#.........#########........#########.........#########.........#########.......#
#.........#########........#########.........#########.........#########.......#
################################################################################