###x########################y############
#.........#.#.#.....#.....#...#...#.#...#
#####.#.###.#.#.#.#.###.###.#.#.###.###.#
#.#...#.#.......#.#...#.#.#.#.#.....#...#
#.###.###.#.###########.#.###.###.###.#.#
#...#.....#.#.#.#.....................#.#
#.#.#.#.###.#.#.#####.#######.#.#.#.#.#.#
#.#.#.#.#.....#...#.#.....#...#.#.#.#.#.#
#.#####.#####.#.###.#.#.#.#.###.#.###.###
#.#.........#...#.....#.#.#...#.#...#...#
#.#.###.#.#.###.###.###.###.#####.#####.#
#.#.#.#.#.#.#.#...#.#.....#.#...#...#...#
#.###.#.#####.#.#.###########.#.#####.###
#.....#...#...#.#.............#.....#...#
#.#.###.#####.#####.#.#.#######.###.#.###
#.#.....#.......#...#.#.#.#.#.....#.....#
#.#####.###.###.#.###.###.#.#.###.#.#####
#...#...#...#.#...#.....#...#.#...#.#.#.#
#.###.#####.#.#####.###.#.#######.###.#.#
#...#.#.#.......#.#.#.....#.....#.....#.#
#.#####.###.###.#.#########.#.#.###.###.#
#...#.#.....#.............#.#.#...#.....#
#.###.#######.###.#######.###.###.#######
#...#...#.#.....#.....#...#.....#.....#.#
#.#.#.#.#.###.#.###############.#######.#
#.#.#.#.#.#...#.....#...#.........#.....#
#.#.###.#.#.#.#.###.#.###.#####.#.###.###
#.#.....#.#.#.#...#.......#.#.#.#.#.....#
#.#####.#.#####.###.#.#####.#.#.#.###.#.#
#.#.....#.........#.#.#...#.#.#.#...#.#.#
#######.#####.###########.#.#.###.#####.#
#...#.#.#.#.#.....#...#.#.#.....#.......#
###.#.###.#.#.#.###.#.#.#.###.#####.###.#
#.#.....#.#...#.#...#.................#.#
#.#.###.#.#######.#####.#.###.#######.###
#.....#.............#.#.#.#.........#.#.#
#####.#.###.#########.#####.###.###.#.#.#
#.#.#.#...#.#.#.........#.....#...#.#...#
#.#.#.###.#.#.###.###.#.#.#######.#####.#
#.......#.#.#.....#...#.........#...#...#
#########################################