#x###################################################################################################
#.#...#...#.#.....#...............#.......#.#.......#...#.........#...#.....#.......#.....#.#.......#
#.#.#.#.###.#.#.###.###.#.#.###.###.#.#.#.#.#.#####.#.###.#.#####.###.#.#####.#####.#.#.###.#.###.###
#...#.#...#.#.#...#...#.#.#.#.#.#...#.#.#...#.....#.#.#.#.#.#.......#.....#.#...#...#.#.#.#.#.#.....#
#.###.###.#.###.###########.#.###########.###.#.###.#.#.#.#.###.#####.#.###.###.#######.#.#.###.#.###
#...#.#.#.#.......#.#.#...#...#.#.......#...#.#...#.#...#.#.#.#...#...#...........#.....#.#...#.#.#.#
#####.#.#.#####.#.#.#.#.#####.#.#.#.###.#.#.#.#.###.#.#.#.#.#.#.#.#.#########.#.#.###.###.###.#.###.#
#.........#.....#.......#.........#...#.#.#.#.#.#.....#...#.#.#.#.#...#.......#.#.#.........#.#.....#
#.###.#.#.###.#.#########.#.#########.#.#.#######.###.###.###.#.#######.#####.#####.###.#####.#####.#
#.#...#.#...#.#...#.#.#...#.#.........#...#.....#...#.#.#.#...#.#.......#.......#.....#.#...........#
#######.#.#####.#.#.#.#.#######.###.#.#.#.#.###########.###.#.#.#######.#.#########.###.###.#.###.#.#
#.......#.#.....#...........#...#...#.#.#.....#...#.#.#.#.#.#.....#.....#.......#.....#.#...#.#.#.#.#
#########.#.#.#############.#########.#######.#.###.#.#.#.#####.#.#######.#####.#.#####.###.###.#.###
#.#...#.....#.#.....#...#.#.#.....#.#.#.#.......#.....#.........#.#...#.#.#.........#.#.......#.....#
#.###.#.###.#.#.#######.#.#####.###.#.#.###.###.#.#######.#########.###.#####.#######.#.#############
#.......#...#...........#.........#.....#.#.#.....#.#...............#.#.....#.#.#...#.....#.#...#.#.#
#.###.#.###.###.#######.#.#####.#####.#.#.#.###.#.#.#########.#####.#.#.#.#.###.#.#.#.###.#.#.###.#.#
#.#.#.#.#...#.#...#.#.......#.#.#.....#.#.#.#.#.#.....#.#...#.....#...#.#.#...#.#.#.#.#.#.....#.#...#
#.#.###.#####.###.#.#######.#.#.#########.###.#.#.#####.#.#.#.###.###.#######.#.###.#.#.#######.###.#
#.#.......#...#...#.#.........#...#...#...#...#.#.....#.#.#...#.#.#.....#...#.....#.#.#.........#...#
#####.#.#.#.#######.#.#######.#####.###.#.#.###.#.###.#.#####.#.#####.###.#.###.#.#.#.###.#########.#
#.#...#.#.#...#.#.........#.#.#...#.#...#...#...#.#.#.#.....#.#...#.....#.#...#.#.......#.......#...#
#.#.#.###.#.###.#.###.#####.###.#.#.#.###.#####.###.#######.#####.#.###.#.#########.#.###.#.#######.#
#...#.#.#.#.......#.......#.....#.#...#...#.................#.#.#.#.#...#.......#...#...#.#.........#
#######.###.#.#.#.#.#####.#####.#.#.#############.#.#####.###.#.#.#####.#######.###.###.###.#.#####.#
#.#.....#...#.#.#.#.....#.#.#...#.#.#.....#.#.....#.#.........#...#...#...#.........#...#...#.#.....#
#.###.###.###########.###.#.#####.#.###.#.#.###.#.###.###.#######.###.#.#####.###.###########.#.#.###
#.....#.......#.....#.#...#.#...#...#...#.#.#...#...#.#.#.#.#.#.#.#.#.#...#...#...#...........#.#...#
###.#####.#.#.#####.#######.#.#####.#.###.#.#.###.#####.#.#.#.#.#.#.#.###.#.#######.###.###.###.###.#
#.....#.#.#.#.#.#...#.......#.#...#.#...#.....#.#.#.....#.......#.....#.....#.....#...#...#.#...#...#
###.###.###.###.#.###.###.###.###.#.#.#####.#.#.#.#####.#####.#.#.#######.###.#.###.#######.###.#####
#.......#.#...#.....#.#.....#.....#.....#.#.#...#.....#.......#.....#...#.#...#...#...#...#...#.#...#
###.#####.#.#######.###.#.#.#.###.###.###.#.###.#####.#.#.#######.#.#.###.#######.#####.#####.###.###
#...#.#...#.#.#.#.......#.#.....#.#.....#.....#.....#.#.#.......#.#.#...#...#.#.#.........#.#...#...#
#.#.#.###.#.#.#.#.#.###.#################.#########.#####.#.###.###.#.#.#.#.#.#.#######.#.#.#.###.###
#.#.....#.#...#...#...#.......#.........#.#...#.....#.....#...#...#...#...#.#.......#...#.#.....#...#
#.#####.#.###.###.#####.#######.#########.#.#.#.#######.#####.#######.###########.#.#.###.#.#######.#
#...#...#...#...#...#.#.#.#.#.....#...#.#.#.#.......#...#.#.....#...#.#.#...#.#.#.#...#.....#.....#.#
#.#.#####.#.#####.#.#.###.#.#.###.###.#.#.#####.#####.###.#########.###.#.###.#.#.#######.###.#####.#
#.#...#...#.#.....#.#.....#...#.....#.....#.........#.#.#...#.....#...#.#.......#.#...#.......#...#.#
#.#####.#####.#####.###.#####.###.#####.###.#########.#.#.###.#.#####.#.#.#.#####.###.#######.###.#.#
#...#...#.#...#.#...#.#.......#...#.#.#.#.#.#...#.#.........#.#.......#...#...#.....#.....#.#.#.....#
#.###.#.#.#.#.#.###.#.#######.#.#.#.#.#.#.#.#.#.#.#.###.#.#.#####.###.###.#####.#######.###.#.###.#.#
#.#.#.#.....#...#...#...#.#.#.#.#...#...#.#.#.#...#.#.#.#.#.#...#.#.............#.........#.#.....#.#
#.#.#.###########.###.###.#.#.#.#####.###.#######.#.#.#.#####.#########.#####.#.#.#####.###.#.#.###.#
#.....#.....#.........#...#.#.#.#...#.#.........#...#.....#.#...............#.#.#.....#.....#.#...#.#
###.#######.#.#####.#####.#.#.#.###.###.#######.###.###.#.#.#####.#######.#########.#######.###.#.###
#.#.......#.#.#.....#.....#.#.#.#.#...#.#.#.......#.#...#.....#...#.#.#.#.#.....#.........#...#.#...#
#.#.#######.#####.#####.###.###.#.###.#.#.###.#####.###.###.#.###.#.#.#.#######.#######.#######.#####
#.#.....#.#...#.#.#...#.....#.........#.....#.......#.....#.#.#.#...#...#.#.......#.....#.....#.#.#.#
#.###.###.###.#.###.#####.#.#####.#.###.###.#####.###.###.#.#.#.#.#.###.#.###.#####.#####.#####.#.#.#
#...#.................#...#.....#.#...#.#.......#.#...#...#.#...#.#.....#...#.....#...#.........#.#.#
#.###.###.###.#####.#.###.#########.###.#######.#.###.#########.#.#####.#.###.#.#.###.#.#########.#.#
#.......#...#.#.....#.........#.........#.......#.#...#.....#...#...#.#...#...#.#.#...#...#.........#
#####.###.#.###.###.#######.#####.#.#######.#.#.###.#.#.###.###.###.#.###.###.###.#.###.###########.#
#.....#.#.#.#.#.#...#...#...#...#.#...#.#...#.#.#.#.#.#.#...#.........#...#...#.#.....#.#.......#...#
#######.#.#.#.#.#####.#####.#.#.#.#.#.#.###.###.#.#########.###.#.#.#########.#.#.#######.#.#.#.#.###
#...#...#.#...#.#...#.#.......#...#.#.#.....#...#.....#.........#.#...#.#.#...#...#.#...#.#.#.#.#...#
#.#.#.###.#####.###.#.#.###.#.#.###.#####.#####.#.#.###.#####.###.#####.#.#.#.###.#.#.#######.#####.#
#.#.........#.......#.#.#...#.#...#...#...#.....#.#.#.#.....#.#.#...#.....#.#.#.#.....#...#.....#...#
#.#######.#.#####.#.#.#.#.#####.###########.#.#.###.#.###.###.#.###.#.###.#####.###.###.###.#.#.#.###
#.#...#...#.....#.#...#.#.....#.....#.#.#...#.#...#.#.....#...#.#.#...#.#...#...#...........#.#.....#
#.###.#######.#.#######.#####.#####.#.#.#####.#.###.#.#.#######.#.#.###.#######.#####.###.#.###.#.###
#.#.....#...#.#.......#...#.#.#...#.....#.....#.....#.#...#.#...#.#.#.#.....#.....#.#.#.#.#.#...#...#
#.#####.###.#.#############.#####.#####.#######.#####.#####.###.#.#.#.###.#.#####.#.#.#.#########.#.#
#.#...#.........#.......#.#.......#.#...#.....#.#...#.#...#.#.#.#...#...#.#...#.#...#.#.#.#.....#.#.#
#####.#.###.#######.#.###.#.#.#####.###.#.#.###.###.#.#.###.#.#.#.#.###.###.#.#.###.#.#.#.###.#.###.#
#.#...#.#.#...#.....#...#.#.#...........#.#...#.#.#.#.#.#...#.#.#.#.#...#...#.....#.....#.#...#.#.#.#
#.#.#####.#####.#.#####.#.#####.#.#########.#####.#.###.#.###.#.###.#.#.#.###.#####.#.###.#.#####.###
#...#...#.......#.....#.....#.#.#...#...........#.#.#.#.......#.......#.#.#.....#...#...#.#.#.#.....#
#.#.#.###.#######.#####.###.#.#.###.#######.###.#.#.#.#####.###.###.#########.#.#.#####.#.#.#.#.###.#
#.#.....#.#...#.#.#.#.....#.....#.....#.#.#...#.#.#.#.............#.....#.#.#.#...#.....#.#.......#.#
#.###.#####.#.#.###.#.#######.#####.###.#.#####.#.#.#######.#########.###.#.#####.#.#.###.###.#.#####
#...#.#.....#.....#.#.....#.#...#.#...#.......#.#.#.....#.....#.#.......#...#.....#.#.....#...#...#.#
#.#.#.#######.#####.#.#.###.#####.#####.#######.#.#.#####.###.#.###.###.#.#.#.#.#####.###.#######.#.#
#.#.#.....#.#...#.#.#.#.#.#...#.....#.............#.....#.#...#.....#.....#.#.#.#.....#...#.......#.#
#.###.#####.#.###.#.#####.#.###.###############.#.#.#########.###.#.###.#########.#.###.###.#.#.###.#
#.#...#...#.#.#.....#.....#...#.......#.........#...#.....#...#.#.#.#...#.........#.#.#.....#.#.....#
#.#.###.#.#.#.#.#.#####.#.#.###.#.###.#######.#####.###.#######.#.#.###.#.#.#.#.###.#.#.#####.#.#####
#.#.....#.......#.......#.#.#...#.#.....#.....#.#.......#...#.....#.#.....#.#.#.#.#.#.......#.#.#...#
###.###.#.###.#.#####.#.###.#.###.#.#.#.#.#####.#######.#.#####.#.###.#######.###.#.#.#.#######.#.###
#...#...#.#...#.#.....#...#.#.#...#.#.#...#.......#.............#.#.........#.#...#.#.#.#.#...#.....#
#.#########.#####.#.#.#####.#####.#########.###.#.#####.#.###.#####.#######.#####.###.###.#.###.#####
#.#...#.......#...#.#.......#...#...#.....#...#.#.....#.#.#...#...........#...#...............#.....#
#.#.#.#####.#####.###.#####.#.#######.#########.#.#########.#.#.#####.#.#.#.#.#.###.###.#####.#####.#
#.#.#.#.......#.....#...#.#...#.#.#.....#.#.....#.#...#.#.#.#.#.....#.#.#.#.#.#...#.#...#.........#.#
#.#.#####.#.###.#######.#.#.###.#.#.#.#.#.#####.#####.#.#.#.#####.#########.#####.###.###########.###
#.......#.#...#.#.......#.#.#.#.#...#.#.#.#.....#...#.......#.#...#.#...#.....#.#...#.#.#.#.#.....#.#
#.#####.#.#####.#.#.#####.#.#.#.#.#######.#####.###.#.#.###.#.###.#.###.###.###.#####.#.#.#.#.###.#.#
#.....#.#.#.....#.#.......#...........................#...#...#.....#...........#...........#...#...#
###################################################################################################y#