###################################################################################################################################################################
#.#.#.#.#.#.#.#.#.#.#.#.#.#.#.#.#.#.#.#.#.#.#...#.#.#.#.#.#.#.#.#.#.#.#.#.#.#.#.#.....#.#.#.#...#.#.#.#...#...#.#...#.#.#.#.#...#...#.#.#.#.#.#...#.....#.#...#...#
#.#.#.#.#.#.#.#.#.#.#.#.#.#.#.#.#.#.#.#.#.#.#.#.#.#.#.#.#.#.#.#.#.#.#.#.#.#.#.#.#.#####.#.#.#.#.#.#.#.#.#.#.###.#.###.#.#.#.#.###.###.#.#.#.#.###.#.#####.###.#.###
#.#.#.....#...#...#.....#.#.........#.........#...#.............#...#...........#.#.......#...#.#.#.#...#...#.....#...#...#...............#.......................#
#.#.#.###.#.###.#######.#.###.#####.#.#.#.#####.#.#.#.#######.###.###.#######.#.#.#.#.#.#####.###.#.#.#.#####.#.###.#.###.#########.#######.###############.###.###
#.#...#...#.............#.#.#.....#.#.#.#.#...#.#...#...#...#...#.....###.###.#...#.#.#.........#.#...#...#...#.#...#...#.........#...###...###.......#...#...#...#
#.#####.###.#####.###.###.#.#.###.#.#.#.###.#.###.#####.#.###.###.#######.###.#####.#.#.#####.###.#######.#.###.#.#####.#########.###.###.#####.###.#.###.###.#####
#.#...#.#...#.....#...#...#...#...#.#.#...#.#...#.....#.#...#.....#.................#.#.....#.#.........#...#.#...#####.............#.....###...###.#...#.....###.#
#.#.###.#####.#########.#######.###.###.#####.#.#######.###.#######.#####.###########.#####.#.#.#######.#####.#.#########.#######.###########.#####.###.#####.#####
#.#...#.....#.###.......###...#.#.#...#...#.#.#.........#...#.......###.#...#.......#.....#.#.#.#...#.#...#.....#########...#...#...#...###...###...###...#...###.#
#.###.#####.#.###.#########.#.#.#.###.###.#.#.#############.###########.###.#.###.#######.#.#.#.#.###.###.###.#############.###.#.###.#.###.#############.#.#######
#...#.....#.#...#.#.......#.#...#.#...#...#...#.......#.......#.......#.....#.#...........#.#.#.#.......#.....#############...#...#...#.....#############...#####.#
#.#.#.#.###.#.#.#.###.###.#.#####.#.###.###.###.#####.###.#.#.###.###.#######.###.#######.#.###.###.###.#####.###############.#####.###############################
#.#.#.#.....#.#.#.#.....#...#.#.....#.....#...#...#.#.#...#.#.....###.......#...#.#.....#.#.....#...#.....#...###############.......#############################.#
#.#.#.#########.#.###.#.#####.#.#######.#####.###.#.#.#####################.###.###.###.###.#####.###.#####.#######################################################
#.#...#.....#...#.#...#.....#...###...#...#.#.#...#.#.#.#...###.......#.....#.....#.#.#.....#...#.#...#.....#####################################################.#
#.#####.###.#.###.#######.#.#.#####.#.###.#.#.#.###.#.#.#.#.###.#####.#.#####.#####.#.#######.###.#.###.###########################################################
#.#...#.#.#...#.#.......#.#.#...###.#.#...#...#.#.#.#.#.#.#.#...###...#...#...#...#.#.........#...#.#...###########.....................#########################.#
#.#.#.#.#.#.###.#######.###.###.###.#.#.#####.#.#.#.#.#.#.#.#.#####.#####.#.###.#.#.#######.###.#####.#############.###################.###########################
#...#...#...#.#.........#...#.......#.#.....#...#.....#.#.#...###...#.....#.#...#...#.......#.....#...#############.###################...#######################.#
#######.#####.#.#.#.###.#.###########.###.#.#####.#####.#.#######.###.#######.###.###.#######.#.###.###############.#####################.#########################
#.#...#.#.......#.#...#.#.#.....#...#...#.#.#...#.#.....#.#.###...#.....#...#...#.#...#.......#.#...###############.#######...###########...#####################.#
#.#.#.#.#.#############.#.#.###.###.###.###.#.###.#.#.###.#.###.#######.#.#.###.#.###.#.###.#.###.#################.#######.#.#############.#######################
#...#.....#.............#.....#...#.....#...#.#...#.#.......#...#...#.....#.....#.#...#.#.#.#.#...#################.###.....#...###########...###################.#
#.#####.###.###################.#.###.#####.#.#.###.#########.###.#.#########.###.###.#.#.#.###.###################.###.#######.#############.#####################
#.#####.#...#.................#.#...#.......#.#.#.........#...###.#.......###...#.#.....#.#.....#######.........###.#...#######...###########...#################.#
#.#####.#.###.###########.#.#.#####.#.#######.#.#######.###.#######.#####.#######.###.###.#####.#######.#######.###.#.###########.#############.###################
#.#...#.#.#.....#...#...#.#.#.#.....#.#...###.#.......#.#...#.....#...#.#...#...#...#.#.....#...#######.#######.###...###########...###########...###############.#
#.#.#.#.#.#####.#.#.#.#.#####.###.###.#.#.###.#######.###.###.###.###.#.###.#.#.###.#.###.#.#.#########.#######.###################.#############.#################
#...#.#.#.....#...#...#.....#...#...#.#.#...#.......#.....#.....#.........#.#.#.###.#...#.#.#.#.........#######.....#############...###########...###############.#
#####.#.#####.#############.###.#.#.#.#.###.#.#####.###########.#########.#.#.#.###.#.#.#.###.#.###################.#############.#############.###################
#...#.#.#...#.......#.......#...#.#.#.#.#.#.#...#.#...#.......#.....#...#.#.#.#...#.#.#...#.#.#.###################...#########...###########...#################.#
#.###.#.#.#.#####.#####.#####.#####.###.#.#.###.#.###.###.#.#.#.#.###.#.###.#.###.#.#####.#.#.#.#####################.#########.#############.#####################
#...#.#...#.#.#.#.....#.#...........#...#.#.#.......#...#.#.#...#.#...#.....#.#...#...#...#...#...........###########...#####...###########...###################.#
#.#.#.#.#####.#.###.###.#############.###.#.#######.###.###.#######.#######.###.#####.###.###.###########.#############.#####.#############.#######################
#.#...#...#...#...#...#.#.#...#.......#...#.......#.#...........#...#...#.#...#.......#.....#.......#####.#############...#...###########...#####################.#
###.###.#.#.###.###.#.#.#.#.#.#.#####.#.#.#######.#.###.#.###.###.###.#.#.#.#.#######.###.#.#.###########.###############.#.#############.#########################
#.#.#.#.#.#...#...#.#.#.....#.#.#.......#.......#.#...#.#...#.#...#...#.#...#...#.....#.#.#.#.#...........###############...###...#####...#################.......#
#.#.#.###.###.###.#.#.###.###.#.#######.#.#.###.#.#####.###.###.###.#####.#####.#.###.#.###.#.#.###############################.#.#####.###################.#######
#...#.....#...#.#...#...#.#.............#.#...#.#.#.#...#.#.....#.#...#...#...#...#.#.#...#.#.#.#############################...#...#...#################...###...#
#.#.#.#####.###.###.#.#####.###.#########.###.#.#.#.#.###.#######.###.###.###.#####.#.#.###.#.#.#############################.#####.#.###################.#####.###
#.#.#.#.....#.....#.#.......#.#.#...###.......#.#.#...#.....#.........#...#...#.....#.#.....#.#.#########################.....#####...#################...#.......#
###.#.###.###.#.###.#########.#.#.#.###.#.#####.#.#.#####.#.#.###.#######.#.#####.#.#.#.#.###.#.###########################.###########################.###.#.#####
#.#.#...#...#.#.....#...#.......#.#...#.#.#.#...#.#.......#...#...#.........#...#.#...#.#.#...#.#####...###########.......#...#######################...#...#.#...#
#.#.###.###.#.#####.###.#.#######.###.#.###.###.#.###########################.#.#.#####.#######.#####.#.###########.#.###.###.#######################.#####.###.###
#...#...#...#.#.......#.#.#.........#...#.......#.........................###.#...#.#.#.#.......#####.....###...###.#.#.....#...#####################.#...........#
###.###.#.###.#####.###.#.#########.#########.#.#########################.###.#####.#.#.#.#############.#.###.#.###.#.#####.###.#####################.###.###.#####
#...#...#.###.#...#.#.....#.....#.#.#...#...#.#.......#...#.......#...#.#.###...#.#.....#.###...###.#...#.......###.#.....#...#...###################.#...#.......#
###.#.###.###.#.#.#.#######.###.#.#.###.###.#.#.#####.#.#.#.#######.#.#.#.#####.#.#.#####.###.#.###.#.#####.#.###########.###.###.###################.#########.###
#...#...#...#...#.#.#.......#.#.#...#.......#.#.....#...#...........#...#.#...#.#.....#...#...#.#.....###.....###.#######...#...#...###########.......###.........#
#.#####.###.#####.#.#.#######.#.#.#####.#######.###.#####.#.#.###########.#.#.#.#######.###.###.#.#######.#.#####.#######.#.###.###.###########.#####.###.#.#######
#...#...#...#...#.#.#.#.........#.......#####.#.###.....#.#.#.#...........#.#...#.......###.........###...#...#.....#####.#...#...#...#######...#...#.#...#.......#
#.#.#.###.###.###.###.#####.###.#######.#####.#.#######.#.#.#.#.###########.#####.#########.#.###.#.###.#######.###.#########.###.###.#######.###.###.###.#####.###
#.#.#.....###.....#.#.....#...#.....###.....#.#.#.......#.#.#.#.#...............#.###.........#.........#...###.###...#######...#.#...#######.#.#.....#...#...#...#
###.#.#######.#####.#####.#########.#######.#.#.#.#######.#.#.#.###.###########.#.#######.###.#.###.#.#####.###.#####.#######.#.###.#########.#.#.#####.#.#.###.###
#.#.#.#.....#.........#...#...#...#.#.....#.#...#.#####...#...#.#.............#.#.#.........#.....#...#####.....#####...#####.#.....#######...#...#.....#.#.....#.#
#.#.###.###.###.#######.#.###.#.#.#.#.###.#.#####.#####.#.###.#.###############.#.#.#.#.#.###.###.###.#######.#.#######.#####.#############.#####.#.#####.#########
#.......#.#.#...#.....#.#.###...#.#.#.#...#...###.#####...#...#...............#.#.#.#.#.#...........#...###...#...#####...###.###########...#...#...#...#.#.#.....#
#.#######.#.#####.###.###.#######.#.#.#.#####.###.#####.#.#.#################.#.#.#.###.#.#.###.###.###.#####.#.#.#######.###.###########.###.#######.###.#.#.#####
#.#.......#.#.....###.#...#...#...#.#.#.#####.....###.#.#...#.#.#...#.......#.#.#.#...#.#...#.......#.....###...#.....###...#.#########...#.#.#...#.#.....#.......#
###.#.###.#.#.#######.#.#.###.###.#.#.#.#############.#.#.###.#.#.#.#.#######.#.#.#.#.#.#.#####.#####.#.#.#########.#.###.###.#########.###.#.#.#.#.#.#######.#####
#...#.#...#...#...#.#.#.#.#...#...#.#.#.........###.#.#.#.#.......#...#.......#.#.#.#...#.............#.#...#####...#.#...###...........#.......#.....#.......#...#
#.#.#####.#######.#.#.###.#.###.###.#.#######.#####.#.#.#.#####.#####.#.#########.###.#######.#.###.###.#.#.#####.###.#.###################.###############.#.#.###
#.#.#...#.#...#...#.#.....#...#.#...#...#...#.......#.#.#.......#...#.#...........#.......###...#...###...#...###.......#######.......#...#.#...............#.#...#
#.###.#.#.###.#.#.#.#######.###.#.#####.#.#.#####.###.#.###.#####.#.#.###############.###.###.###.###########.#####.#.###############.#.#.#.###.#############.#.###
#.....#.#.....#.#.#...#...#.....#.#...#.#.#...#.#...#.......#...#.....#######...###...#.#.....#.#.#####.........#.....#########.......#.#.#.....#.........###.....#
###.###.#######.#.###.###.#####.#.#.###.#.#.#.#.###.#########.#.#.###########.#.###.#.#.#####.#.#.#####.#########.#############.#######.#.#########.#####.#####.###
x...#.#.........#.#.#.#...#.......#.....#.#.#.....#.#...#.....#.#.#...#.......#.###.#.#...#.#...#...#...#########.#############.........#.......#...#...#.........#
###.#.###.###.###.#.#.###.#.#######.#######.###.#.#.#.#######.###.#.#.#.#######.#####.#.###.###.###.#.###########.#######################.#####.#.#.###.#.#####.###
#...#.....#.....#...........#...............#.......................#...#.............#...........................#######################.....#...#.....#.....#...y
###################################################################################################################################################################
