##x#.#..##.........##.######################################
#........#......#..##........#########....######.###########
#...#...#.........#.####.#.#####..............######..######
#...#...#.........#.#......................................#
#####.#.#.........#.#......................................#
##....#.#......#.##.#......................................#
##..#.............#.#......................................#
##########....#.#.#.#..............####....................#
#..........#......#.#..............#..#....................#
...#.#.#...#......#.#..............#.##....................#
#########..#........#..............#.#.....................#
################.##..................#.....................y
############################################################