#############################################x######
#...................................#....#.........#
#.....#..#.####.####.####.....#..#....#.....###.####
#..#..#..#.#....#....#..#.##.#####.#.######..#..#..#
#..#..#..#.#....####.#.##..#.......#...#..#.....#.##
#..##.#..#.#.......#.#....######.#####.#..######...#
#...#.####.####.####.#...................##.#......#
#.###..................######...########..#....#.#.#
#.#...#.#.......#......#......#......#.........#.#.#
#.#.###.#..#.#..#..#.#.#..#########..#.#.#...###.#.#
#.......#..#.#.....#.#.#......#......#.#.#.......#.#
#.#.#####..#.###.###.#...#.#######.#...#.###.#######
#.#........#.........#...#....#....#...#...........#
#.#...##..######.######.##..#####..##.######...##.##
#.#....#..#...........#.#...........###.........#..#
#...##.#..#.##..#..##.#.#.###...###.#.#.##...##.#..#
#...#..#..#.#.......#.#.#.#.......#.#.#.#....#..##.#
#.#.#.....#.#.##.##.#.#.#.#.......#.#.#.#.##.#.....#
#.#...#.#.#.#..#.#..#.#.#.#########.#.#.#..#...#.###
#.#...#.#.#....#.#....#.#...........#.#....#...#.#.#
#.....#.#.##.#.....#.##.##..#####..##.##.#.....#.#.#
#.###...#..#.#.###.#.#...#....#....#...#.#.###...#.#
#..#..#.#..#.#..#..#.#...#.#######.#...#.#..#..#.#.#
#..#..#....#....#....#.#.#....#....#.#.#....#..#...#
#..#..#.#..#.#..#..#.#.#....#.#.#....#.#.#..#..#..##
##y#################################################