#x################################
#...#...#........................y
#.#...#.#.########...#############
#...#...#...#...#.#..#############
#.#...#.#.#.#.#.#..#..############
#...#...#........................#
#.#...#.#........................#
#...#...#........................#
#.#...#.#........................#
#...#...#........................#
#.#...#.#........................#
#...#...#........................#
#.#...#.#........................#
#...#...#........................#
#.#...#.#........................#
#...#...#........................#
#.#...#.#........................#
#.....#.#.....##################.#
#######.#######.#....#..##.....#.#
#.......#.......#.....#..#..##..##
#.#######.......#....#..#..#...#.#
#.#.............#..#..#..#....#..#
#.#.#####.......#...#..#.....#...#
#.#.....#.......#..#..#.....#....#
#.#####.#.......#.#..#....#......#
#.......#............#...........#
##################################