#x#######
#.#. #..#
#.#. #..#
#...... y
#########